NO ./textures/north_texture.xpm
SO ./textures/south_texture.xpm
XX ./textures/wrong_texture.xpm
EA ./textures/east_texture.xpm
F 220,100,0
C 225,30,220

# 오류: 'XX'는 유효하지 않은 키입니다. 'NO', 'SO', 'WE', 'EA', 'F', 'C'만 허용됩니다.

111111
100001
10N001
100001
111111
