NO ./textures/north_texture.xpm
SO ./textures/south_texture.xpm
WE ./textures/west_texture.xpm
EA ./textures/east_texture.xpm
F 220,100,0
C 225,30,220

# 오류: 맵이 완전히 벽으로 둘러싸여 있지 않습니다. 마지막 줄의 '11011'에서 맵이 열려있습니다.

111111
100001
10N001
100001
11011
