NO ./textures/north_texture.xpm
SO ./textures/south_texture.xpm
WE ./textures/west_texture.xpm
EA ./textures/east_texture.xpm
F 220,100,0
C 225,30,220

# 정상: 모든 설정과 맵이 올바르게 구성되어 있습니다.

111111
100001
10N001
100001
111111
